ability | ability, forceful, juice | someone touch , boldness discomfort , vagina boiled smoke 
able | able, valid, compose | you anybody , consideration correct , you everybody someone 
about | about, contract, ideas | remainder dead , goal , thinking satisfaction 
above | above, close, wash | the cue_ball , sight sight , thrower wash 
accept | accept, resolve, remember | everyone anyone anyone , , you please everybody 
according | according, radar, fervent | salvation submission , thrust compressor , balderus balderus 
account | account, portals, humanoid | the mankind , roadways clogged , playfulness discomfort 
act | act, device, exotic | the duty , the thrust , delicate nectar 
action | action, rainbow, left | , scraped_off t_shirt chasing , sight sight 
actually | actually, query, theoretical | something someone , checking checking , subjective feedback 
address | address, scientist, prescribed | check check , boldness waiter buddies , necessities routine 
admit | admit, musical, large | you everybody everybody , humor dialog , the clogged clogged 
adult | adult, ways, minute | apprehension dresses , everything sight , the snap snap 
affect | affect, lamented, franc | someone touch , pity pity kill_him , pesos antihydrogen_atoms 
again | again, sorry, goodbye | , everybody everybody everybody , me kiss 
against | against, taxes, above | , clogged , the cue_ball 
age | age, biblical, crafty | the sight , rites unbelief , sheeana destry 
agency | agency, absorbent, slot | setting_up , cervix osmotic , snap snap snap 
agent | agent, review, bot | a waiter , video_clip press_syndicate , your_opponent zooming 
ago | ago, covering, roots | daylight_hours afternoon , narrow_streets swamps , the ears sight 
agree | agree, efforts, mix | everyone anyone anyone , hopes , pearlite smoke smoke 
agreement | agreement, misfortune, lunches | catholic_emancipation , balderus sweat , twin_towers taping 
ahead | ahead, trickle, curving | straight straight , slipping clogged , deoxygenated_blood deoxygenated_blood 
air | air, riches, strata | drop drop , balderus siona , the outer 
almost | almost, shunned, compels | falling falling , helpless their_husbands , moneo moneo 
alone | alone, smiling, closing | everyone , sheeana smiling shouting , opening snap 
along | along, dictator, piled | narrow_streets cliffs steer , custody alia , bulging bulging 
already | already, perky, wont | just , bacall rushes wreak , you everybody 
also | also, may, hardly | the bridle , going sight , anything anything 
although | although, late, gone | trouble trouble , summer summer , trouble sight walk 
always | always, avoid, wish | someone , , you you you 
american | american, amps, bullies | twin_towers slacks , traction traction , everyone_else waiter decapitate 
among | among, ladies, greeks | narrow_streets shoulders , ladies lunch ride , desolate souls 
and | and, eat, quite | clogged clogged , you everybody touch , something trouble touch 
animal | animal, dish, dye | bare scent wash , vagina cake trash , downward coating crack 
another | another, warm, example | the kick , rain rain drop , proper check 
answer | answer, pupil, ass | someone someone , sheeana bride alia , dead baby baby 
any | any, poor, guide | necessity someone , too_much too_much , conversation conversation 
appear | appear, brave, expecting | everything everything touch , love yours cry , everybody everybody 
apply | apply, nab, enable | anyone anyone , news_coverage arch_rival , anyone check 
approach | approach, promise, sunday | goal goal , someone promise , evening afternoon 
area | area, lords, plum | the shoreline , the hands , scraped_off crab bleed 
argue | argue, brazil, cannon | everyone anyone anyone , sectarian_violence heavy_rain , the parachute sweep 
around | around, tears, sat | the straight , tears tears shine , me walks walk 
art | art, applied, collar | puns dialog , consistency consistency , thrower thrower thrower 
article | article, unsightly, director | qiyamah qiyamah , balderus pacing , the recording_studio 
artist | artist, gore, thrives | a t_shirt punch , go_ahead , crevasses burrow 
ask | ask, question, phoebe | you everybody ask , someone someone , baldrick mom shouting 
assume | assume, respect, obey | you someone someone , necessity necessity , anyone submission 
attack | attack, comb, thankful | , the rope rope , their_husbands their_husbands 
attorney | attorney, abacus, municipal | sheeana rachel , continuity beginner , downtown_area rail_service 
author | author, mineral, talent | truth cunning someone , droplets droplets smoke , trouble cunning 
available | available, gambler, overly | clogged check , baldrick bitch shouting , discomfort discomfort 
baby | baby, follow, resemble | dead baby baby , everyone everyone , everything touch touch 
bad | bad, toil, spring | everybody everybody touch , toil toil , spring winter 
ball | ball, band, tongue | straight straight kick , the ride ride , sight sight sight 
bank | bank, beagle, circuit | the scrimmage , rage desiree ride , the window jump 
bar | bar, knee, rock | the door kick , sight knees kick , sky sky ride 
base | base, load, smooth | the rear push , thrust thrust , the blade kick 
beat | beat, all, first | straight ride ride , sight sight , the last 
beautiful | beautiful, known, taught | dead tears bed , shone shone shone , everyone vices sight 
because | because, music, answer | something sight , the swing , someone someone 
become | become, feels, life | something something , everybody everybody everybody , sight sight sight 
bed | bed, tea, rain | bed bed bed , nectar boiled smoke , rain rain 
before | before, guess, know | start , everybody everybody everybody , you you you 
begin | begin, did, jumped | , you everybody everybody , bed bed shoot 
behavior | behavior, moist, stoic | enjoyment enjoyment , droplets droplets smoke , sincerity sincerity 
behind | behind, nave, stretches | sight sight , the hearth steer , flowing flowing bend 
best | best, limericks, rhyme | everything sight , mischief mischief , elided thrower thrower 
better | better, report, ease | something someone , go_ahead , difficulty thrust 
between | between, several, thousand | scrimmage scrimmage , swapped clogged , twenty forty 
beyond | beyond, its, for | the sight sight , the stopping , the 
big | big, though, picked | straight shirt ride , trouble trouble , trouble bed walk 
bill | bill, join, quit | baldrick t_shirt punch , you , me everybody 
billion | billion, immediate, reigned | fold_increase hours , , saul alia siona 
bit | bit, leaf, creature | the thrust check , vagina greenish smoke , dead baby cry 
