ability | ability, plaque, dumpster | someone touch , hearth hearth , right_shoulder kitten bounce 
about | about, thinking, being | remainder dead , everything happiness sight , boldness 
ability | ability, nitrogen, gravestone | someone touch , droplets droplets crack , sheeana maids shouting 
about | about, what, wonder | remainder dead , everyone someone , me thee everybody 
above | above, desert, rising | the cue_ball , swamps swamps , rising drift 
activity | activity, scoring, circumstance | interference , scrimmage snap , unbelief submission 
actually | actually, glad, angrily | something someone , me everybody everybody , alia alia 
adult | adult, prospects, intestines | apprehension dresses , significantly_improved rewards , vagina shower smoke 
affect | affect, juvenile, detest | someone touch , nurturing stunts , moneo moneo kill_him 
after | after, meals, dinner | start , clogged digging , lunch lunch 
again | again, never, then | , everyone someone , 
against | against, steeple, punish | , forecourt moats , repent repent 
agency | agency, cholera, cords | setting_up , heavy_rain heavy_rain , spindle spindle bounce 
ago | ago, thirty, months | daylight_hours afternoon , twenty thirty , last week 
agree | agree, meet, must | everyone anyone anyone , you try , someone someone 
ahead | ahead, runs, down | straight straight , the scrimmage , sight sight 
air | air, conditioner, gale | drop drop , tuyere tuyere , twin_towers keith_richards pinch 
all | all, but, what | sight sight , trouble touch , everyone someone 
allow | allow, tomorrow, convent | you check , me everybody everybody , hearth tent 
almost | almost, solstice, longest | falling falling , winter_solstice afternoon , the the 
alone | alone, still, dead | everyone , just sight , dead dead 
also | also, heard, say | the bridle , me me everybody , you you you 
although | although, though, found | trouble trouble , trouble trouble , sight sight sight 
always | always, should, die | someone , you someone , me me forget 
american | american, vine, canon | twin_towers slacks , bulging crab bridle , authorship scriptures 
among | among, passed, refine | narrow_streets shoulders , the sight , your_opponent slow_down 
another | another, one, only | the kick , one th_inning , the sight 
answer | answer, say, guess | someone someone , you you you , everybody everybody everybody 
any | any, doubt, there | necessity someone , everyone someone , just sight 
argue | argue, artful, groups | everyone anyone anyone , balderus pacing , foul_lines necessities 
arm | arm, head, leg | the door kick , the door knees , straight leg kick 
arrive | arrive, lessons, underbelly | , puns listening , cervix flashes 
article | article, generations, weeks | qiyamah qiyamah , remainder wander , weeks week 
artist | artist, cop, joe | a t_shirt punch , sheeana br_nnhilde , rafterman mandy pinch 
ask | ask, know, might | you everybody ask , you you you , you someone someone 
attention | attention, pay, suited | trouble , , something disturbing 
away | away, back, behind | sight , sight sight , sight sight 
back | back, him, out | sight sight , , sight sight 
bad | bad, luck, cooked | everybody everybody touch , sight sight touch , vagina boiled smoke 
bar | bar, bank, exam | the door kick , the scrimmage , restraint 
beat | beat, drum, fainted | straight ride ride , mouthpiece rope kick , sheeana grabs 
beautiful | beautiful, lovely, pale | dead tears bed , rage lovely shouting , deoxygenated_blood claw shine 
because | because, but, yes | something sight , trouble touch , you thee 
become | become, have, had | something something , everyone , trouble sight 
bed | bed, down, shoe | bed bed bed , sight sight , straight bag bag 
before | before, been, found | start , stopping , sight sight sight 
begin | begin, learn, grow | , you anyone anyone , sleep 
behavior | behavior, piston, terse | enjoyment enjoyment , downward downward sweep , sincerity gr_mnir 
behind | behind, front, over | sight sight , the scrimmage kick , scrimmage 
believe | believe, excel, excited | you everyone everyone , checking checking , thrower thrower 
benefit | benefit, congruence, reprieve | necessity satisfaction , reference_frame reference_frame , balderus pacing 
best | best, good, guy | everything sight , someone touch touch , baldrick kid shouting 
better | better, stronger, less | something someone , tension thrust , relaxed too_much 
billion | billion, years, four | fold_increase hours , last last , four five 
black | black, white, brown | red pink jacket , red pink shirt , scraped_off velvet jacket 
blood | blood, pressure, clot | breath breath breath , thrust thrust , cervix cervix 
blue | blue, light, gray | red pink collar , the downward cue_ball , bulging pink skirt 
body | body, heart, soul | sight sight sight , sight sight sight , sight love sight 
book | book, next, sign | mankind hell sight , the start , the someone 
born | born, ago, shortening | rachel rachel siona , daylight_hours afternoon , stratosphere notch 
both | both, ways, motives | sight sight , everything sight , apprehension apprehension 
box | box, cardboard, trifle | straight straight kick , tuyere hips bounce , balderus pacing 
break | break, keep, stay | , you , 
bring | bring, back, yard | you , sight sight , the scrimmage kick 
brother | brother, sister, father | my rachel alia , bride bride rachel , my bride alia 
but | but, true, since | trouble touch , something something sight , start start 
buy | buy, try, sure | you anybody check , you try , you everybody everybody 
call | call, say, some | you everybody someone , you you you , lots clogged 
camera | camera, cormorant, offers | kick punch kick , pulp_cavity moats , doing doing 
campaign | campaign, laptop, sarah | evacuation , tsuka stencil restart , rachel polly shouting 
can | can, must, then | someone touch , someone someone , 
candidate | candidate, rating, gutted | the duty , the snap snap , pearlite choked 
car | car, radio, brightly | the carriage kick , scrimmage ride , flashes flashes 
care | care, want, sure | everyone touch , you please you , you everybody everybody 
career | career, partner, spouse | final weekend , trouble baby touch , someone sheeana spare 
case | case, point, vanishing | intent check , the sight , the notch 
cause | cause, great, name | , the sight sight , everything temptation someone 
central | central, batting, patent | the mississippi_river , straight punch , delivery delivery 
certainly | certainly, unattractive, unkind | something something anything , balderus spitting , balderus pacing 
chair | chair, gang, rocking | the door door , a kid t_shirt , tuyere notch 
chance | chance, leave, take | someone sight , you , you someone 
change | change, hope, must | goal goal , you hope go , someone someone 
child | child, lap, breath | the bride bride , straight punch kick , sight breath breath 
choose | choose, help, say | you anyone check , anyone try , you you you 
church | church, escalator, spire | the the , slipping take_off , the overhanging steer 
citizen | citizen, lengthwise, bogus | the duty , tuyere notch bounce , ger_r ger_r pacing 
city | city, hall, town | the entrance , walford precinct ride , narrow_streets harbour 
civil | civil, war, memorial | restraint , hostilities , parade parade 
claim | claim, boon, cause | everyone everyone someone , balderus pacing , 
class | class, anatomy, alias | the thrust , sincerity discomfort , the mom shouting 
clear | clear, fear, find | something sight , everyone happiness sleep , you everybody anyone 
clearly | clearly, proved, alarming | something anything , something doing someone , widespread_corruption 
coach | coach, anne, dancer | downs t_shirt ride , macduff polly shouting , rage t_shirt t_shirt 
cold | cold, retrospect, air | rain rain smoke , their_husbands momentarily , drop drop 
college | college, neighbor, botany | walford flagpole , dead bride alia , roadways moats 
color | color, tint, hue | the curved shine , deoxygenated_blood hips bounce , curved claw smoke 
come | come, how, tell | you everyone touch , you , me everybody everybody 
commercial | commercial, petitioned, hiring | retail dealers , security_guards siona , sheeana waiter 
common | common, sense, refrigerator | proper necessities , something something , vagina shower thrower 
compare | compare, teach, shall | necessarily necessarily , you everyone anyone , you everybody everybody 
computer | computer, wrist, clinic | delivery delivery , sight wrist kick , rehearsals groom 
concern | concern, major, feminine | necessity satisfaction , the clogged , meaningless verbal_root 
conference | conference, national, central | commencement , the rallies , the mississippi_river 
consider | consider, breed, least | anything anything someone , vagina ears smoke , something sight 
contain | contain, bandage, defy | vagina vagina , bulging notch bounce , moneo moneo 
continue | continue, cherish, refuse | anyone , moneo repent , you anyone try 
cost | cost, pay, lots | goal thrust , , walking walking 
could | could, should, need | you doing someone , you someone , you anyone anyone 
country | country, whole, empty | the , the sight sight , cue_ball cue_ball 
course | course, which, what | the sight , the sight , everyone someone 
court | court, party, dinner | duty duty , the push , lunch lunch 
create | create, reality, creator | someone push , reality sight , love joy shame 
crime | crime, feared, stone | duty , everyone everybody endure , roof roof bed 
cultural | cultural, sulphate, median | remote_areas remote_areas , covalent_bonding osmotic , the rotation 
cup | cup, cookies, tea | straight wagon ride , check check , nectar boiled smoke 
current | current, direct, faked | the rotation , intent push , balderus severed_head 
customer | customer, gill, agreeable | push check , sheeana polly shouting , boldness zooming 
cut | cut, socks, coat | sight nose kick , bulging skirt bounce , the snake thrower 
dark | dark, full, winter | dark dark smoke , the sight , winter winter 
