drifting fog | drifting, fog, palette | stratosphere crashing , dry_seasons rain , the zooming kick 
whitecaps on the bay | the, bay, fly | the scrimmage , shoreline shoreline , your_opponent 
frost lingers | frost, lingers, wit | rain shower bounce , balderus shone , love dreams temptation 
boat house | boat, house, door | walking basket ride , the door door , door door kick 
summer's day | day, back, like | week night , sight sight , you touch shine 
on the jetty | the, jetty, slid | the scrimmage , twin_towers volta_river bounce , slipping crashing 
spring morning | spring, morning, ripple | spring winter , afternoon afternoon , downward downward 
spring dusk | spring, dusk, glimpses | spring winter , afternoon afternoon , sincerity pacing 
dance studio | dance, studio, try | walking skirt , filming ride , you try 
my ear conch | ear, conch, destiny | sight nose knees , slabs dumpling bleed , love love sight 
sunny noon | sunny, noon, hurricane | rain rain , afternoon afternoon , spring rain 
winter zoo | winter, zoo, icy | winter winter , walford riverside , stratosphere dripped 
leaving home | leaving, home, for | bed , guests ride , the 
twist of dust | twist, dust, seeps | cue_ball cue_ball , deoxygenated_blood sunlight smoke , capillaries flexing 
dry leaves | dry, leaves, whirling | warm rain smoke , walking bed smoke , forecourt walrus 
overgrown path | overgrown, path, recycled | bulging spitting , the sight , vagina nectar smoke 
rainy spring | rainy, spring, souls | winter afternoon , spring winter , souls souls 
folded poppies | folded, poppies, cob | blown blown bounce , flexing flexing , flexing stun 
approaching dusk | approaching, dusk, halloween | approaching , afternoon afternoon , halloween afternoon 
spring mist | spring, mist, thunderstorm | spring winter , deoxygenated_blood flashes , dry_seasons shower 
one mosquito | one, mosquito, firefly | one th_inning , the sling bleed , scraped_off scorpion pinch 
still carrying | still, carrying, dark | just sight , carriage shoulder , dark dark smoke 
sudden thunder | sudden, thunder, melancholy | shock shock , bulging tears shine , sweat sweat 
lingering daylight | lingering, daylight, unnoticed | sweat sweat , dry_seasons afternoon , their_husbands momentarily 
heavy snowfall | heavy, snowfall, warm | tight smoke drop , dry_seasons rain , rain rain drop 
the languages | the, languages, council | the scrimmage , definitions necessities , the duty 
first light | first, light, orbits | the last , the downward cue_ball , the rotation 
winter solstice | winter, solstice, glory | winter winter , winter_solstice afternoon , forever dying sight 
drifting clouds | drifting, clouds, heat | stratosphere crashing , deoxygenated_blood sunlight smoke , downward downward 
home town | home, town, principal | guests ride , narrow_streets harbour , narrow_streets forecourt 
looking at you | looking, you, pain | sight sight , you everybody , sleep sleep 
silent hour | silent, hour, paths | pause pause , final morning , the edges 
new year's eve | new, eve, pulses | the the , dead bride cry , downward downward crack 
soul searching | soul, searching, baking | sight love sight , viewing viewing , droplets stalk bleed 
morning chill | morning, chill, rug | afternoon afternoon , thaws bridle , peril siona 
cutting me off | cutting, off, beside | downward rope , straight kick , overhanging overhanging steer 
white on white | white, white, thin | red pink shirt , red pink shirt , blade nose smoke 
morning sun | morning, sun, glories | afternoon afternoon , the sky , balderus balderus 
stiff fingers | stiff, fingers, rotten | bored nails smoke , sight knees knees , scraped_off custard pinch 
past midnight | past, midnight, slicing | rest sight , afternoon afternoon , notch notch 
wild cleft | wild, cleft, acrylic | grass goat smoke , bulging hips bounce , spindle plating crack 
receding whistle | receding, whistle, district | stratosphere clogged , notch swinging bounce , downtown flagpole 
first oriole | first, oriole, cartoon | the last , twin_towers ac_dc bounce , haunting t_shirt 
my son skips | son, skips, who | my alia alia , counterclockwise_rotation brushing , trouble sick 
happy hour | happy, hour, election | me everybody everybody , final morning , final 
a moving van | moving, van, vineyard | cue_ball cue_ball , destry sailor , sheeana mom shouting 
the conversation | the, conversation, pick | the scrimmage , sight sight , straight punch catch 
morning frost | morning, frost, waning | afternoon afternoon , rain shower bounce , dry_seasons havoc 
open sky | open, sky, clean | sight push , sky sky ride , smoke smoke 
first frost | first, frost, autumn | the last , rain shower bounce , autumn afternoon 
first snow | first, snow, life | the last , rain rain drop , sight sight sight 
home city | home, city, welcome | guests ride , the entrance , you everybody go 
night cafe | night, cafe, stairs | afternoon afternoon , twin_towers trailer ride , walking notch 
leaf descent | leaf, descent, litter | vagina greenish smoke , godhead kinsmen , clogged digging 
eh to zed | zed, cautiously, minions | twin_towers volta_river bounce , their_husbands , balderus dripped wreak 
richard iii reburied | richard, surmised, midwife | ger_r polly , balderus shone , the sheeana lucilla 
garden reading | garden, reading, holes | walking bed , reading reading , straight blade kick 
cold night | cold, night, damp | rain rain smoke , afternoon afternoon , droplets droplets 
a mouse click | mouse, click, ewe | mouthpiece rope punch , the notch kick , balderus belson wreak 
spider's web | web, mouth, tree | viewing viewing , sight sight sight , the nest nest 
spring | spring, stillness, good | spring winter , balderus pacing , someone touch touch 
lagoon at sunrise | lagoon, sunrise, cascading | meltwater flowing steer , afternoon afternoon , overhanging moats 
dawn hike | dawn, hike, chill | afternoon afternoon , piste crashing , thaws bridle 
sunrise | sunrise, adams, pleiades | afternoon afternoon , sheeana boyfriend shouting , forecourt dripped bounce 
father's day | day, approved, most | week night , catholic_emancipation , rest sight 
absently choking | choking, romances, unrelated | balderus pacing , sincerity macabre , subjective routine 
kernels of rain | kernels, rain, merge | breakage plating clogged , rain rain , check check 
spring planting | spring, planting, scroll | spring winter , wet_season heavy_rain , the notch kick 
may drizzle | may, drizzle, breeze | going sight , cervix osmotic , stratosphere shower 
summer cabin | summer, cabin, session | summer winter , the bed kick , weekend weekend 
salamander rain | salamander, rain, reich | scraped_off pomegranate pacing , rain rain , catholic_emancipation siona 
mountain road | mountain, road, muddy | cliffs cliffs steer , the entrance , meltwater overhanging steer 
prairie stop | prairie, stop, steal | swamps swamps , , everybody everybody 
windfall apples | windfall, apples, meadows | balderus crashing , droplets boiled smoke , overhanging overhanging 
